//MAP CONVERTED BY dmm2tgm.py THIS HEADER COMMENT PREVENTS RECONVERSION, DO NOT REMOVE
"a" = (
/turf/template_noop,
/area/shuttle/arrival)
"c" = (
/obj/effect/turf_decal/tile/neutral{
	dir = 1
	},
/obj/effect/turf_decal/tile/neutral,
/obj/effect/turf_decal/tile/neutral{
	dir = 4
	},
/obj/effect/turf_decal/tile/neutral{
	dir = 8
	},
/turf/open/floor/plasteel,
/area/shuttle/arrival)
"d" = (
/obj/effect/turf_decal/tile/neutral{
	dir = 1
	},
/obj/effect/turf_decal/tile/neutral{
	dir = 4
	},
/turf/open/floor/plasteel,
/area/shuttle/arrival)
"i" = (
/obj/structure/sign/nanotrasen,
/turf/closed/wall/mineral/titanium,
/area/shuttle/arrival)
"j" = (
/obj/structure/closet/wardrobe/mixed{
	anchored = 1
	},
/obj/effect/turf_decal/delivery,
/obj/effect/turf_decal/tile/neutral{
	dir = 8
	},
/turf/open/floor/plasteel,
/area/shuttle/arrival)
"m" = (
/obj/item/kirbyplants/random,
/obj/effect/turf_decal/tile/neutral{
	dir = 1
	},
/turf/open/floor/plasteel,
/area/shuttle/arrival)
"n" = (
/obj/structure/shuttle/engine/heater{
	dir = 1
	},
/obj/structure/window/reinforced,
/obj/effect/turf_decal/stripes/line{
	dir = 1
	},
/turf/open/floor/plasteel/airless,
/area/shuttle/arrival)
"o" = (
/obj/structure/table/reinforced,
/obj/machinery/light{
	dir = 4
	},
/obj/machinery/cell_charger,
/obj/effect/turf_decal/tile/neutral{
	dir = 1
	},
/obj/effect/turf_decal/tile/neutral{
	dir = 8
	},
/turf/open/floor/plasteel,
/area/shuttle/arrival)
"r" = (
/obj/structure/closet/emcloset{
	anchored = 1
	},
/obj/machinery/vending/wallmed{
	pixel_y = 32
	},
/obj/item/storage/toolbox/emergency,
/obj/item/storage/toolbox/emergency,
/obj/item/clothing/suit/hazardvest,
/obj/item/clothing/suit/hazardvest,
/obj/item/clothing/suit/hazardvest,
/obj/item/clothing/suit/hazardvest,
/obj/item/clothing/head/hardhat/orange,
/obj/item/clothing/head/hardhat/orange,
/obj/item/clothing/head/hardhat/orange,
/obj/item/clothing/head/hardhat/orange,
/obj/effect/turf_decal/delivery,
/obj/effect/turf_decal/tile/neutral,
/obj/effect/turf_decal/tile/neutral{
	dir = 8
	},
/turf/open/floor/plasteel,
/area/shuttle/arrival)
"t" = (
/obj/machinery/door/airlock/shuttle,
/obj/effect/turf_decal/stripes/line{
	dir = 4
	},
/obj/effect/turf_decal/stripes/line{
	dir = 9
	},
/obj/structure/fans/tiny,
/turf/open/floor/plating,
/area/shuttle/arrival)
"u" = (
/obj/structure/chair/comfy/shuttle{
	dir = 4
	},
/obj/effect/turf_decal/bot,
/turf/open/floor/plasteel,
/area/shuttle/arrival)
"w" = (
/obj/machinery/light/small{
	dir = 4
	},
/obj/structure/chair/office/light,
/turf/open/floor/plasteel,
/area/shuttle/arrival)
"x" = (
/turf/closed/wall/mineral/titanium,
/area/shuttle/arrival)
"C" = (
/obj/effect/spawner/structure/window/shuttle,
/turf/open/floor/plating,
/area/shuttle/arrival)
"D" = (
/obj/structure/shuttle/engine/propulsion{
	dir = 1
	},
/obj/effect/turf_decal/stripes/line{
	dir = 1
	},
/turf/open/floor/plasteel/airless,
/area/shuttle/arrival)
"F" = (
/obj/structure/table/reinforced,
/obj/item/storage/dice{
	pixel_x = -2;
	pixel_y = 8
	},
/obj/item/toy/cards/deck,
/obj/machinery/requests_console{
	department = "Arrival shuttle";
	name = "Arrival shuttle requests console";
	pixel_x = 32
	},
/turf/open/floor/plasteel,
/area/shuttle/arrival)
"G" = (
/obj/machinery/computer{
	dir = 1;
	name = "Shuttle computer"
	},
/turf/open/floor/plasteel,
/area/shuttle/arrival)
"H" = (
/obj/effect/turf_decal/caution{
	dir = 4
	},
/obj/effect/turf_decal/tile/neutral,
/obj/effect/turf_decal/tile/neutral{
	dir = 4
	},
/turf/open/floor/plasteel,
/area/shuttle/arrival)
"J" = (
/obj/structure/table/reinforced,
/obj/item/radio/intercom{
	pixel_x = -30
	},
/obj/item/paper_bin,
/obj/item/pen,
/turf/open/floor/plasteel,
/area/shuttle/arrival)
"K" = (
/turf/closed/wall/mineral/titanium/nodiagonal,
/area/shuttle/arrival)
"L" = (
/obj/effect/turf_decal/tile/neutral{
	dir = 4
	},
/turf/open/floor/plasteel,
/area/shuttle/arrival)
"M" = (
/obj/structure/closet/wardrobe/grey{
	anchored = 1
	},
/obj/effect/turf_decal/delivery,
/obj/effect/turf_decal/tile/neutral,
/turf/open/floor/plasteel,
/area/shuttle/arrival)
"O" = (
/obj/effect/turf_decal/tile/neutral{
	dir = 1
	},
/obj/effect/turf_decal/tile/neutral,
/obj/effect/turf_decal/tile/neutral{
	dir = 4
	},
/obj/effect/turf_decal/tile/neutral{
	dir = 8
	},
/obj/effect/landmark/start/chief_engineer,
/turf/open/floor/plasteel,
/area/shuttle/arrival)
"P" = (
/obj/machinery/light{
	dir = 4
	},
/obj/structure/sign/poster/official/enlist{
	pixel_x = 32
	},
/obj/effect/turf_decal/tile/neutral{
	dir = 1
	},
/obj/effect/turf_decal/tile/neutral{
	dir = 8
	},
/turf/open/floor/plasteel,
/area/shuttle/arrival)
"Q" = (
/obj/structure/chair/comfy/shuttle{
	dir = 8
	},
/obj/effect/turf_decal/bot,
/turf/open/floor/plasteel,
/area/shuttle/arrival)
"R" = (
/obj/docking_port/mobile/arrivals{
	dir = 2;
	dwidth = 2;
	height = 16;
	name = "omega arrivals shuttle";
	width = 5
	},
/turf/closed/wall/mineral/plastitanium/nodiagonal,
/area/shuttle/arrival)
"T" = (
/obj/machinery/door/airlock/shuttle/glass,
/turf/open/floor/plasteel,
/area/shuttle/arrival)
"X" = (
/obj/structure/extinguisher_cabinet{
	pixel_x = -26
	},
/obj/effect/turf_decal/tile/neutral{
	dir = 4
	},
/turf/open/floor/plasteel,
/area/shuttle/arrival)
"Z" = (
/obj/structure/closet/crate/internals,
/obj/item/storage/firstaid/o2,
/obj/item/tank/internals/emergency_oxygen,
/obj/item/tank/internals/emergency_oxygen,
/obj/item/tank/internals/emergency_oxygen,
/obj/item/tank/internals/emergency_oxygen,
/obj/item/clothing/mask/breath,
/obj/item/clothing/mask/breath,
/obj/item/clothing/mask/breath,
/obj/item/clothing/mask/breath,
/obj/effect/turf_decal/delivery,
/obj/effect/turf_decal/tile/neutral{
	dir = 1
	},
/turf/open/floor/plasteel,
/area/shuttle/arrival)

(1,1,1) = {"
a
K
x
t
x
C
C
K
C
C
t
i
x
a
a
a
"}
(2,1,1) = {"
D
n
M
H
X
u
u
J
u
u
H
L
x
x
C
C
"}
(3,1,1) = {"
R
K
r
c
c
c
c
O
c
c
c
d
T
w
G
C
"}
(4,1,1) = {"
D
n
j
P
m
Q
Q
F
Q
Q
o
Z
x
x
C
C
"}
(5,1,1) = {"
a
K
x
x
x
C
C
K
C
C
x
i
x
a
a
a
"}
